WWWWWWWWWWWWWWWWWWWWWWWWWWWWWW
W                            W
W    P                       W
W                            W
W                            W
WWWWWWWWWWWWWWWWWWWWW        W
W                            W
W                            W
W                            W
W    E       E      E        W
W                            W
W                            W
W                            W
W                            W
W                            W
W                            W
W                            W
W                            W
W                            W
W  H  WWWWWWWWWWWWWWWWWWWWWWWW
W                            W
W                            W
W                            W
W      E        E      E     W
W                            W
W                            W
W                            W
WWWWWWWWWWWWWWWWWWWWWWWWWWWWWW