WWWWWWWWWWWWWWWWWWWWWWWWWWWWWW
W      W                     W
W   P  W                     W
W      W               H     W
W      W                     W
W      W                     W
W                     E      W
W                            W
WWWWWWWWWW                   W
W                            W
W                            W
W                            W
W                            W
W                            W
W                            W
W                            W
W                            W
W                            W
W                            W
W        E                   W
W                            W
W                            W
W                     E      W
W                            W
W                            W
W     H                      W
W                            W
WWWWWWWWWWWWWWWWWWWWWWWWWWWWWW