WWWWWWWWWWWWWWWWWWWWWWWWWWWWWW
W                            W
W                            W
W  E E E E E E E E E E E E E W
W                            W
W                            W
W                            W
W                            W
W         H    H    H        W
W                            W
W                            W
W                            W
W E E E E E E E E E E E E E  W
W                            W
W                            W
W                            W
W                            W
W                            W
W                            W
W                            W
W                            W
W                            W
W           WWWWWW           W
W                            W
W                            W
W             P              W
W                            W
WWWWWWWWWWWWWWWWWWWWWWWWWWWWWW